Date,Details,Debit,Credit,Balance (GBP)
16-01-19,WRT Coin Tranfer-In,,1000.00,1000.00
24-01-19,Deposit,,50.00,1050.00
25-01-19,Deposit,,50.00,1100.00
20-03-19,Deposit,,200.00,1300.00
16-04-19,Deposit,,50.00,1350.00
16-01-20,WIN (22.5% APR),,292.68,1642.68
